ID - id	

hotel - Hotel name

canceled - Value indicating if the booking was canceled (1) or not (0)	

year - Year of arrival date	

month - Month of arrival date

week number - Week number of the arrival date	

day - Day of the month of the arrival date

weekend nights stays - Number of weekend nights (Saturday or Sunday) the guest stayed or booked to stay at the hotel
	
week nights stays - Number of week nights (Monday to Friday) the guest stayed or booked to stay at the hotel adults children	

meal - Type of meal booked. Undefined/SC – no meal package;BB – Bed & Breakfast;HB – Half board (breakfast and one other meal – usually dinner);FB – Full board (breakfast, lunch and dinner)
country	- Country of origin. Categories are represented in the ISO 3155–3:2013 format

repeated guest	- Value indicating if the booking name was from a repeated guest (1) or not (0)

deposit	- Indication on if the customer made a deposit to guarantee the booking. 
No Deposit – no deposit was made; In case no payments were found the
value is “No Deposit”.
If the payment was equal or exceeded the total cost of stay, the value is set as “Non Refund”. 
Non Refund – a deposit was made in the value of the total stay cost;
Otherwise the value is set as
“Refundable” Refundable – a deposit was made with a value under the total cost of stay.

agent - ID of the travel agency that made the booking

customer - Type of booking
Contract - when the booking has an
allotment or other type of contract
associated to it;
Group – when the booking is associated to a group;
Transient – when the booking is not part of a group or contract, and is not associated to other transient booking;
Transient-party – when the booking is transient, but is associated to at least other transient booking

reservation status -  Reservation last status,
Canceled – booking was canceled by the customer;
Check-Out – customer has checked in but already departed;
No-Show – customer did not check-in and did inform the hotel of the reason why

reservation status date - Date at which the last status was set.


